EEWEEEEWWEEEEEWWEWEEWWWEEWEWWWWWWEWEEWEEWEWEWEEEWWWWEEEEEEWEWWWEWEWEEEEWEEWEEWWEEWWWWWEEEEWEEEEWEWWWEWEWEEEEEEWWEEWEEEWEEWWEEEWWWEEEWEWEEWWWWWEEEWEEWEWWWWEEEEEEWWWEWEEEWE
EWWEEWEWEEEEEWWEWEEEEEEEWWEEEWEEEEWEEEEEWWWEWEEWEWEWEEEWWEWEEWWWEEEWWEWEEWEEEWEWWWEEEWWEEWWWEEWEWEEEWWEWWEEWEWEEWWWEEEWWWEEEEEEEEEWEEEEWWEEEEEEWEEEWEEEEWEEWEEWWWWEWEEEWEE
WEWEEWEEWWEWEWWEWEEWWEEEWWEWEEWEWWWEEEEEEEEEEEWEWWWWWEEEWEEEEWEWEWEEWEWWWWEWEWEWEWWEWWWWWWWEWEWEEEEWEEEWEEEEWEWWWEEEWEWEWWWWEEWWWWWWWWEEEEWEEEEWEWEEEEWWEWEWEEWWWWEEWWEWWW
WEWEEWWWEEWEEEWEWWWEEWEWWWEWWWEEEEEWWEWEEWEEWEEEEEEEEEWEWEEWWEWWEEEEEEWWWWEWEWEWEWWWWEEWEWWEWEEEEWEWWEWWEWEEWEWEEEEEWEEWEWWEWWEWWEEWWWEWEEWEWEEEEEWEWWWEWEWEWEEWWEEWWWWEAE
WWWWEWEEEEEEEWWEEWEEEEEEWWWWEEEWEEWEEEEEEWEEEWEWWWWWWEEEWEWEEWEEEWEWWWWWWEEWEEEWEWWEWEEEEWWEEWWWWWWEWEEEWEEEEWWEEWWWEEWWEWWWEWWWEWEWWEWWWWEEEEWWWWEWEWEEWWWWEEWEEEEEEWEWEW
EWEWWWEWEEEWWEEEEEEEWEWEWWWWEEWEEWEEEWEEEEEWEWWWEWEWEWEEEEWWWWWEWWEEEEEWWWWWEEEWEEEEEEWWWWEWEWWEEWWWEEWWWWWWWWEEWEWEWEWWWWWWEEWWEWEEEEWWEEWWWWWEEEWEEWWWEWEEEWEWWWWEWWEEWW
EWWEEEEEWWWEEEWWWWWWWWEEWEWEWWWEEWEEEEWWWEWWEWWEWEWEWEWWWEEWEEEEEEWEEWEEEEEWEWEWEEWEEEWEWWWWEWEWEWEWEWEEEEWEEEWWWEEEWWWEEWWEEEWWEEWEEWEEEEWEEWEWEEWWEEWWWEWWWEWWEEWEWWWEEW
EWWEEEWWEEEWEWWEWWEWWWEWEEWEWWEEEWEEEEEEWWEWWWWWEWWEEWEWEWEEEEWWEWWEWEEWEWEWEEWEEEEEEWWWWEWWWWEEWEWEWEWEWEEEWEWWEEEWWWEEEEWWWWEEEEWEWEWEWEWEWWEEEEEEWWWWEEEEWEWWEEWEWEWEEE
EEEWEEEEEEWWWEWEEWWEEEWEWEWEEWWEWWEWWWEWEEWWEWEEEEEWWWEWWWEWWEEWWWEWWEEEEWWWEWWWWWEEEEEWEEEWEEWWEWEWWEEEEWWWWWEWWEWEWEWEWEEWEEEWWEWEWWWEWWWEWEWEEEEEWWEEWWEWEEWEWWWEEEEEEW
WWEEEWEEEWEEEWEEEWWWWEWWEWEEWEEWWEWEWEEWEWWEWWEWWWEEWEWEEWEEWWEWWEWWWEEWEEEEEWWEEWWWWWWWWEEWEEWWWEWWEWWEEWEEWWWEWEEEEWEWWEWEEWEEWEWEWWWEEEWWWWEEWEEEWWWWEWWEEEEWEWEWWEEEWW
WEEEEEEEWEWWWEEWWEWEWEEWWEEWWEWEWWWEEWEWEEWEWWEEEWWWEWEEEEWEWWEEWWWEWEEWEEWEWWEEWEWWEEWWEWEEEWEWEWEEEEWEWEEEEWEWWWWWEEEEEWWWEWEEEEEEWEWWWEEWWEWWEWEEWEEWWWEWEWEEWEWWEEEEEE
WEWEWEWEEWEWWEWWWWWWWEEWWEWWWEEWWEEEEEWEWEWEWEWWWWEWWWEWWEEWEEWEWWEEWEEWEWWEEEEEEWEEEWWEWEWEEEWEWWEEWWEWEEEWWWWEEWWEEWEWEEEEWWEWEWWWEEEEWEEWWWWWEWEEWEEWWEEWEEWWEWEWWEEWEE
WWWEEEWEWWWEWEEEWWWWWEEEEEWWEWEEWWEEEWWEWEWEWEWWEEWEEWEWWEEEEEEWWEWEEEEEEEWWWEEEEEWWWEEEWEEEWWWWEEEWEEEWEWEWEWWWWWEEEEEWWWWWWEEEWEEWWEWEEEWEWWWEEWWEEWEWEWEEEWWWEWEEEEWWWE
EEWEWEEWEEWWWEWEEEEEEWEEWEWEWWWWEWEWEWEWEWWWWEEWEWWWWEWWWWWEEWWEWWEEEEEWEWWEEWEEEEWEEWWWEWWEEEEEWEWWWWEWEWWEWEEWEEEEEEWEEEEEEEWEEEWWEEWEWEEEWEWWEWEWEEWEEEEEEWWWEEWEWEEWEE
EWWEEEEEWEEWWWWWEEEEWEEWEEEWWWEWEEEEWEWEEWEEWEWWEEWWEWWEEWEEWWEEEEWWWWWWWWEEWEEEWEEEWEWWWEEEEEWWWWEEWEWWEWEEWWEEEWWWEEWWEWWEWWWEEEEWEEWEWEWEEWEEWWEWWEEEWWWWEEEWEEEEEWEEWW
EEEEWEEEEEWEEEEEEEWEWEEEEEWWWEWWEEWEEEWWEEWWWWEWWWEWEEEWWWEEEWEEEEWWEEWEWEEWEEWEEWEWWWWWEEWWWWWEWWEWEWEWWEWWWWWWEWEWWWEWEWEWEEEEEEWEWEWEEWWEWEWWWEWWEEWEEWWWEWWWWEEWEEEEWE
WWEEWWWEEEWWWWWEWWWWEEWEEEWWEWEWWEEEEEWEEEWEEEEWWWWEEEEEEWEEEEEEWEEWWWWWWWWEEWWEEEWEEWEEEWWWEWWEEWWEEEWEWWEWWWWEEEEWEEWEWEWWEWEWEWEEEWEEWWEWEWWEWEEWEWWEEWWWEWWWEWWEWWWEWW
EEEEWWWEWWEWWEEEWWWEEWWWEEEWWWEWWEEWWEEWWEWEEEWEWEEWWWEEWEEWWEEEEWEWEWEWEEEWWEEEWEEEWEEEEWEWWWEWEEEWWEWWEWEEWWWEEWEEWWWEEEEWWWEEWWWWEEEWWWEWEEWEWEEEEWWWWWEWEEEWEEEWEWWEWE
EWWEEWEEEWEWWEWWWWEEEWWEEEWEEEEEWEEEWWWWEEEWEEWEWWEEEEEWEWEWWWEEEEEWWEWWEEWEWEWEWEWWEWEWEWWEWWEEWWWWEWWEWWWEEEWWEEEEEEWEEEWEEEWWWWWWEEEWEEEEWEWWWWWWWEWEWEWEWWEWEWEEEEWEEE
WEWEWWEWWWEWWEWEEWEEEEWWWEWWEEWEEWWWWWEWWWWWWEEEWWEWEWWEEWEWEWEWWEWWWEWWEEWEEEEEWWWWEWEEEWWWWEWWWWWEEWEEEWWEEEEWWEWEEWWWWWWWEEWEWWWWEWWEEEWWWEWEWEEEEEWWWEEEEEWEWEEWWEWWEE
WEWWEEEWEEEEEWWEEWEEEEEWWEEEEWWEWEEEEWEWEWWEWWEWWWEEEEWWEWWEWWWEEEEEWWWWEWWEEWWEEEWWEEWWEWEEEEEWWWWEEEEEWWWWEWEWEWEEEWEEEEEEWWWEWWWWWWWEEEEWEEWEEEWWEEEEWWWWEWEEEWEWWEEWWE
EEEEWEWEEEWEEWEWWEWWEWWEEEWEWEEEEEWWEEWEWEEEEEWWWWEWEEWEEWEEWWWEEEEEEWWEEWWEWEEWWEWWWWWWWWWEWWWEEWWEEWWWWEWEEWWEEWEEEEWEWEEWEEEWEEEEWEEEEEWEWEEWEWWWWWEWWWEEEWWEWWEEEWWWWE
WWEEWWEWEWWWEWEEWEWWWEEWEWWWWEEEWWEEWEWEWWEWWWEEEEWWEWWWEWEWWEEEEEEEWWEEEWEEWEWWEWEWEEEWWWEWWEEEEWEWEEWWWEEEEWEWWWWWWEEWWEWWEWEEWWEEEWEEWEWEEWEEWWEWWWEWEEWEEEWEWWEWEEWEWE
EWWEEEEWEEWEWEEEEEWEWEEEWWEWEWEWEWEEEEEWEEEWWWEWEWEEWWEEWEEEWWWWWWEWWWWEWWWWEEWWEWEEEEEEEEWWWEEEEEEEWWWWWWWEWWEWEWWWWWEEEEEEWEEEWEWWWEWWEWWWWWEWWWEEWWWWEWWEWEWEWEWEWEEWWE
WWWEWEEEWWEEEEEEWWWEEWEEWWWEWEWEEEEEEWWEEEEEEEWEWWWEEEWWEWEEEWEWEEEWWEWWWWWEWWWWEWEWWEWWWWEWWEEEEWWEWWEWEWEWEEWEWEEEEWWEEWWEEWEEEWEEWWEEEEWEEEEWWEWEWEWWEWWEWEWEEEEEWEEEEE
EEWWWEEWWEEEWEWWWEWWEWWWWWWWEEEWWEEWWWEWWWEEWEEWWWWEWWEWWEEEEWEEEWEWEEEWEEWWWEEEEEWWWWWEWWEEEWWWEEEEWWEWEWWEEEWEWWEWEWEEEEWEEWWEWWEWWWWWWEWEEWWEWWEWWEEWWWEWWEEWWEEWEEEWEE
WEEEEWEEWWWWWWWEWEWWWEEWWWEEWEWEWEEWWWWWEWWWWWEEEEEWEEWWWWWEEWWEEEEEEEEEEWEWEEEEEWWWEWEEEWEEEEWWWEEEWWEEEWWWEWEEEWEEEWEEEEEWWWEWWWEWWWWEWEEEEEEWWEEWWEWEEWWEEEWWEEEEEWEEEW
EEEWEWWEWWEEWEWWEEEEEWEWEEEWWEEEEEWWEEEEEWWWWEWEEWEWWWEEWWEEEWEWWEWWEWWEWWWWWWEWWEEEWEEWWWWWEEEEWWWEEWWEWWEWEEWEEWWEWWWWWWWEEWEEEEEWWEEEWWEWWEWEEEWWWEEWEWWEWWWWEWEEEEWEEE
EEEEEWWEEWWWEEWWEEWEWEEEWWWEWWEWEWEWEWWWEWEEEWWEEEEWWWEWWEWWEEEWWWWEWEWEWEEWEWWWEWWWWWEWWWEEEEWEEEWEEWWWWWEEWWEWWWEEEWWWEWEEWEEWEWEWEEWWWWWWEEEWWEEEEWWWWWWWWWWEWWWWWEEWWW
WEEEEWEWEEWEEEEEEWWEEEWWEWEWWEWWWWEEWWWEWEWWEWEEWWEEEWEEWWWEWEWEWEWWEWWEWWEWWWWWEWEWWWEWWEEEEEEWEEWEWEEEWWEEWWWWWEWEEWWWWWWEWEEEWEWEWEEEEWWEWWEWEEEWEWEWEEWWEWEEEWEWWEWWWW
EEEWEEEWWEWEWWEWWWWWEEWWEEEWWWWWWWEEEWWWEWEWEEEEWEEWEWWEEEEEEEEEEEEEWWEEEEWEWWWEWEEEWWEWWEEEEWEEWWEEEWWEWEEWEWEWWEEWEEEEEWEWWWEEEWWEWEWEEWEEEEEWWWEEEWWWEWWEEWWEWEEEEEEEEE
EWWEWEWEEWEWEWEWEEWEWWEWWEWWEEWWEEWEEEWEEEEEEEWEWWEWEEEWEWWWWWWWEWWWEEEEEWWWEWWWEEWEWEWWEWEWWEEWWEWWWEWWEWEWWWEEWEEWEEEWEEEEEEWWEWEWWWEWWEEWEWWWEEEWWWEWWWWWWWEWWEEWWWEEEW
EWEWEWEEWEWEEEWEWEEWWWWEWEEEWWEWEEWEEWWEEWWEEWEEWEEEWEEWEWEWEEEWWEWWWEWEWWEWEEWEWEEEEWWWWEEEWEEWEEEEWEEEWEWEWWWEEEEEEWWWWWWEEWWEWEWEEEEEEWWEEWWWEEEWEEWEEEEWEEWEEEEWWEEWWE
WEEWEWWWEEEEWEEEEWWWEWWWEEWEEEEEEWWWWWEWWEEWEWEEEWEWEWWWEEEEWEWEEWWWEEWEEWWEEEEWEEWEEEEWWEEWEEWEEWEEEWEWEWEWWWWEEEWWWEEWEWEEWEEEEWEEEEWEWEWWEEWEWEEEWEEWEEWEEWWEWWWEEWWWWE
EWWWWEEEEWEWWEEWEEEWEWWWEWWEEWEEEEWWWEEWWEEWEEWEEWWWWEEWWEWWEEWWWEWEWWEWWWEWEEEWEWEEEEEWWWEEWWEWEEEWEEWWWEEWEEWWEEEWWWWEEWWWWWEEEEEEEWWWWWWWWEEEWWEEWWEWWEWWEWEWEWEWEEEWEW
WWEEWEEWWEWWEEEWEEWWWEEEEWEEWWWWEEWEWEWWWEEWWWEEEWWWWEWWWEEEWWWWEWEEWWWWWWWEWEEEWEWWEEEWWWWEEWEWEWEEWEEEEEWWWWWEWEEWWWEEWEEEEEWEEWEEEEWEWWEEEEEWEEWEEWWEWEEWEEEWEWWEWWEEEW
WEEEWWEEEEWWEEWEEEEWWEWEEWEWWWEWWEEEEWWWWWWEWEEWEEEEWEWEWWEEEEWEWEEEEWEWWEEWWEWWWWWWEWEEWEWEEEEWWEWWEEEWEWEWWWWWEEEEWEWWEWWWEEEWWWEWEWWWWEWEEEWWWEEEEWEWEWWWWWEEEEEWEWWWEE
WWEWEWWEEEWWEWEEWWEEEEWEEWWEWWEEWEEWEEWWWEWEWEWWWEWEWWWWWEEWEEWEWWEEWEEWEWWEWEWWWEEEEEEWEWEWWEWWWEWEEWEWWWWWWWEEEEWEWWEEWEEEWEWWWWEWEWEWWEEEEWEEEEWWEEWEEWEEEEEEEEEEEWWWWE
WEWEWWEWWWWEWWEEWEEEWEEEWEWEWEEWEEWWWEEWWEEEWWWWWWWWEEWEWWEEWEWEWEEWEEEWWWEEEWWWWEWWEEEEEWWEEWWWEWEWEEWWEEWWWWEEWWWWWEEEWWWWEWEWWEEWWEWEWEWWEWEEEEEEWEWEEWWEEWEWWEWEEEEWEW
WEEWWEEWEWEEWEWEEWEEEEEWEEEWWWEWEWEEWWWEWEEWEWWWEEWEWEWEEEWWWWEEWEEEEEWEEEWWWEEWEEEWEWEEWEWWWEWEWEEWEEWEWEEEEWEWEEEEEWEEWEEWEEWEWEEEEEWEEEEEWEEEWEWEEWWEWWWWWEWWWWWWEWWEWE
EWWEEEEEEWWWEEEEWEEEEWWEWWEWEEEEEEWEEWWEWWWEWEEEEEEWWWWEEEWWWEEEWWEWEWEWEWEEWEEWWEWWWWEEWWWEWEEWWEEWEEEWWWEEWWEEEWWWWWEEWWEWWEEWWEWWEEEWEEEEWWEEWWEWWWEWEEWWEEWEWEEWEWWEEW
EEEWEWEWWWEWWWWEWWWEEWEEWEWEEEEEWEWWWWEWWWWWEEWWWWEEWEEWEEEEWWWWEEEEWWWEWWEWEWEEEEEWEWEWWWWEEEEEWWEEWEWEWEWWWWWEEEWEWWWWEEWWEEWWWEEEEWWEWWWEEEEWWEEWEWWEWEEEEEWEEEWEWWWWWW
EEEWEEWEEWEWEEEEEWWEWEEEWWEWWWWEEWEWEEWWEEWEEWEWEWEEEWEEWWEWEEEEWWWWWEWEEWEEWEEWWWWEEWWWEEWWWEWWEWEEEWEEWEEEEWEEWEEWEWEWWWWWEEWEEEWEWEWEWEEWEEEWEEEWWEWWWEWEWWEEWWWEEEWEWW
EWEWWWEEWEEWWEEWWEEWWWWEWEWEWEWEWWWWWWWEWWWEEEWWWEEEWWEWEEWWWEWEWWEWWWEWEWWWEWEWEEWWWEEWEWEEEEWEEEEEEEWWEEEWEWEWEEEEEEEWWEWEEWWWEEWWWEWEWEWWEEWWEWEWWWWEWWWWWEEEWWWEEEEWEW
EWEEEEWWEEWWWEEEWEWEWWEEEEEEEWEEWWEWWEWWEEEEEEEWWEWEEEEEEEWWEEWEWEEEWWWWWEWWWWWWWEEWEWWWWWEWEEEEWEWEEWWWEEEWWWEWWWEWEWWWWEWEEEWEWEWEWWEEWEEEWWWWWEEWWWEEWEWEWEWEWWWEWWWWWE
WEEEWEEEEEWWEWEWEEEEWWWWWWWEEWWWEEWWEWEWEWWEWEEWEEWWEWEEWWEEWWWWEEWEEEEWEWEEEWWWEWWWWWEEEWWEWWEWWEWEWEWWEWWWWEEWEWEEWWWWEWEWEEWEWWEEEEWEEEWEWWWEWEEWWWWEEWEWEWWWWWEWEWEEWE
WWEEEWEEEWEWEEWWWWEEWEEWEWWEWEEEWEWEWWWWWEEWWWWEEWWEEEWWWEEEWWEEEEWWWEWWEEWWWWEEWEWWWWWWEEWEWWEWEEWEWWEEEEEEWEEEEEEWEWWEWWWEWEEEEWEWWWEWEWWEWWEEWEEEEEWWWEWWEEWEWEWWEEWEEE
WEWEEWEEWEWEWWWEEWWWWWWEWEWWWWWEWEWWWWEEEEWEEWEWEEWEEWEWEWWWEWEWEEWEWWEWWWEWWEWWWWWEEEWWWEWWEWEEEEEEEWWWWWWEEEWWEWWWEEEWWEWWWWEWWEWEEWEWWEWEEWWWWWWWEEWEEWWWEEWWWWEEEWWWWW
WEWEEEEWEWWWEEEWWEEEEEWWEWWEEWEEWWEEWWEWWEEEEEEWWEEWEEWEWEWEWWWEWEEWEEWEEEEEWWEEWEEEEEEWWWEEWEWEWEEEEEWEEEWEWWEWWWEEWEWEWEEEWWEEEWEWEEEWEWWWEWEEEEEEWWWWEEEEWEWEWEEWWEEEWW
WWWEEWEEEWEEEEEEWWWEWWWWEWEEWWWEWEEEWEEEWWWWWEEWEWWWEEWWWEWEEWWWWEEEWWEEEWEEWWEWEWEWWWEEWEWEWEEWEWEEEEWWWWWEWWEWWWEEEWEEEWWWEEEEWWEEEEWWEWWWEWEWEEEEEWEWWWWEEWWWWEEWWWEWWE
EWEEEEWEWEEEWWWEEWWEEEWWWEEWEEWWWWEEWWEWWEEEWWEEEEEWWEWWEWEWEWEEEEEEWEEWWWWEEEEWWEEEWWWEEWWEEEEWEWWWEWWWEWWWEEEEEEEWWEWEEWEEWWWWEEWEWEEEWWEWEWEEWWWWEWEWEEWEEEEEWWWEEWWEWW
WWEEEEWEWEEWWWEEWEWWEEWWEWWEEEWEEEEEEWWWWWWEEWEEEEWEWWEEWWWWEWEWEWEWEWWWEWEEWWEEEWEEWWEEEEEEWEEWWWWWWEWEEWWWWEWEEEWEWWWEWEWEWWWWEWWEEEWWEEWWEWEWWEWWWWWWWEEEEWWEEEWEWWWEEW
WEEEWEEWEEEWEEWEEEEWWEEEEEWEEEEEWEEEWWEWEEEWWWWEWWEEWEEEEEEEWEWWEWEEWWEEWEWWEWWEEWEEEWEEWEEEWWEEEEEWWEEEEEEWWWWWWEEEWEWWEEEWWEEWWWWEWEEEWEWEEEEEEEWWWEWEWWEWWEWWWEEEWEWWEW
EEWEEEWEEEEEWWEEEEWEWEEWEEEWEWWEEEWEEWWEEEWWWEEWEWEEEEWWEEWEWEWEEWWWWWWWWEEWEEWEWWWWWWWWWEEWWEEWWWEEWEWEEWWWWEEWWEWEEEEWEEWEWWEWEEEEEEWEEEEWEEEWWEEWWEEWWEEEWWEEEWEEWWWWEE
EWEWWWEEWWWWEWWWWEEWWWWWEWEWEEWWEEEEWEWWEWWEWEEWEWWEEWEEWEEEEWWWWWEWWEWEWEEWEEWWEEWEWWWWWWEWWEEWEWEWWWEWWEWWEWWEWEEEEEWWEEEWEEWWEWEWEWEEEWWWWWEEWWWEEEEWWWEEEWEEWWWWEWWEWE
WEWWEWWEEEEWWWEWWWEEEEWWWEWWEWEWWWWWWEEEWWWWWWWEWEWEWEWEEEEWEWWWWEEWWEEWEWEWWWEEWWWEWEWEEWWEEEEEEEEWEEEEEWWWEWWEWWEEEEWEWEWWWEEEWEWEWEEWEEWWEWWWEEEWEEWWEEEEEWEWWEWWEEWEWW
WEWWEEEEWWWEWWEEWEEWWWWEEEWWEEWWWWEEWWWWWWEWWWWEEWEEWEEEEEEEWWEEWWWWEWWWWEEEWEEEEEWEWWWEEEWEEEWEWEEWWWEEEWWWEWWEWEEWEWWWWWWEWWWWEEWEWEWEEWEEWEEEWWEEEWEWEWEWEEWEEEEWWEWWWW
WEEWWWWWWEEWWWWWWWWWEWWWWWEEWEWEWWWEWWEWEWEEEWWWEEEWEEWEEEEEWWEEEEWWWEEEEEEWEWWWWWEEEWEEEWWEWWEEWWWWEEWWWEWEWWWEWEWEWWEWWWEEEWEEEWWWEEWWWWWEEEWWWEWWEEEEEEEWEWWEWEWWEEEEWE
EWWWEWEEEEEEEEWEEWWEEEWEEWEEWWEWEEEEEEWWEEWEWWEEEWEEEEWEWWWWWEEWWEWEWWEWWEWWWEEWEEWEWEEEEWWEEWWEWWWEWWEWWEWWEEEWWWEWEEWWEWEEEEEWWEWWWEWEEWEWEWEEEWEWEEWEWEEWEEEWWEWEWWWEWE
WWWEWWEWEWEWEWWEEEEWEEEEEEEEEEEWWEEWEEEEEWWWEWWWEEWWEEWEWWWEWWEEWWEEWWEEWWEEWEEEEWEEWEEWWEWWWEEWEEEWEEWWWWEEEWEWEEWWWEWEEEEWWWWWEEEWWWWEEWWWEEEWEEWWEWWEEWWEEEEEEEEWWWWEWW
WWWEWEWWWWEWEWEEEWEEEEWEEWEWEWWEEEWEWWWWEWWWEWWWWEWWEEEWEEWEEWEWWEWWWEEEEEEEWWWEWEWWEEEEWEEWEWWEEEEEEWWWEWWEEEEEEWEWWEWEEEWWEWEEEEWEWEEEEEEWEWWWWWEWWEWEEWWWWWEEEEWWEEWWEE
WEWEEEWEEEWWEEWEWEWEEWWWWWEWWEEEEEEEWEWWWEWWWWWEWEWEWWEEWEEEWEWWWEEWWWEWEWWWWEWEWEEWWWEWWWWWWWEEEEEWEEEEWEEWEEEEEEWEEEEWEWEWEWWEWWWWWWEWWWEEWWEWWWWEWWWEEEEWEWEEWEEWEWEWEW
WWEEWWEWWEEWWEWWEWEEWEWEEEEWEEEEEWWWWWEEEEEWWWEEWEWEWEEWWWEEEEEWEEWEEWWWEWEEEEWWWEEWEWEWEWWEEEWEEEEEEEWWEWWWEEWEEEWEWEEWEWEWWEEWEWEEWEEEEWEEEEEWEEEWWEWEEWEWWEEWEWWWWWEEEE
WWEWWEWWWWEWWWWWWEWWEEWWEWEWEWWEEWEWEWWEEEEEEWEWWEEEEWEWWEWEEEWEEWWEEWEEEEEWWEEWWEEWEWWWWWWWEWWWWEEWWWEWEEEEWEWEWEWEWWWEEEWWEWWWEEWWWWEWEEWWEEWEEWWEEEEEEWWEEEEWWWEWEWWEWE
EWEEEEEEWEEEWWWWWEWEWEEEEEEEEEWEEWEWEWEWWWEWWEEWEWWEWWWWWWEWEEWEEEEEEEEEWEEWWWEWEEWEWEWEWEEEEWEEWEEWEWEWWWWEEEEEEWEEEWEWWEEEWEWWWEWEWWEWWEEEEEWEWWWEWEEEEEEWWWWEWEEEWEWEWW
WEEEEEWEWEWEEEWWEEWEEWEEEEEEEWEEWWWEEEEEEEEWWEWWEWWEWEEWEEWWWWWEWWEWEEWEEWWEEEEEEEEWWWEEEEEWEEWWEEEWWEEWWEEEWWEWWWEWEWWWWEEEEWWEWWEEEEWEWEEWEEWWWEEEWEEEEEWEWEWWWWWWWEWWWW
EEEEEEEWEEEWEWEWEWEWWEWEWEWEEEEEWEEEWWWWWWEEEWWEEWEEWEEEEEEWWWEEEWEWEWEWWEEEWWEEEWWEEEWWEEWWWEWWWEEWWWEEWWEEWEEWWWEEWEEWEEEEWEWEEWEWEWEEWWEEWEWEEEWWEEWWEWWEEWWWEEEEEEEEWW
EWWWWEEEWEEEEEWEEEWWEEWEWWWWEWEWWWWEWEEEWWWEWEWWEWEEWWWEWWEEWEEWEEWWEEEEEWEWWWWWWEEEWWEWEWEEEEEWWEWEWWEEEWWWWWEWEEWWEWWEWEEEEWWEWEWEEEWWEWWEWWEEWWEEEEEEWEEWWEEEWEEEEWWEWE
WWEEWWWEWWWWEWEWWEWWEWWEEWWWEWEWWEWEEEWEEEWWWEWWEWWEWWEEWEWWEWWEWWWEWEWWEEWWEEEWEWEEEEEEEEEWEEEEWWWWEWWEWEWWWEWEEEEWEEWWEWEWWEEEEWWWWWWWEEEWWWWEEWWEEWEWWWEEWEEEEEWEEWEEWE
WWEEWEWWEWWWEWWWWEWEEWWWEWEWEWWEWWWEWEWWEWWEWEEEWWWWWWWWWEWEEWWEWEWEWEWWWEWEEEWEEWEWWEWEWWWEEWWWWWWWEEWWEEEEEWEWEWWEWEWEEWWWEWWEWWWEWEEWWEEWEWEWWWWWWEEWWWEWWWWWEWEWEWWWWW
WWWWEWEWWEEWEEWEEWEEWEEWWEWWWEWEWEEWWWEWEEEEEWEEWEEEWWWEWWWEWEEEEEEWEEEWWEEWEEEEEEWWWWWEWWWEEWWEWEEWEWEEWWWWWEEEWEWEEEEEEEWWEEEWEWWEEEEEEEWWEWWEWEWEEWEWEWWWWEEWWEEEWEEEEE
EEWWEWWEEEWEEWEWEEWWWEWEEEEWWEEEEWWEEEEEWEEWEWWEWWWWWWEEWWEWEEEEEWEWEEWEWWWEEEWWWWWWEEWEWWEEEWWEWEWEEWEEEWEEEEEWWEWEWEWEEEEWEEEWWEEWEWWEWWWEWEWWWEEWEEEEWEEEEWEWEWEWWWWWWE
EEWWEEEEEWEWEWWEEEEWEEWEEEEEWWWEWWWWWEEEEWEEEEWEEEEWEEEWWEEEEEWEWWEEEWEEWWWEWWEEEWEWWEEEEEEWWWWEWEEEWWEEWWEWEWWEEEWEWEEEWEEWWWWEEEWWWEWWEEWWWEEWEEWEEWEWEEEEWEWWWEEEWWWWEW
EWEWWEEEWEEWWWEWWWWWWEEWEEEWEWEWEWEWEWWWWWWEEEEWEEEEEWWEWEWWEWWEEWEWWEEEWEWEWWEEWWWEEWWWWWEEWWEEEEEWWEEEEWEEWEWEWWWEWWEWWEWWEWWEEEWWWEWWWEWWWWWEEEEEEEEWWEEWEEEEEWEEEWWWWE
WEWEEWEWWWWEEEEEWEWEWEWWWWWEWEEEWWWEWEEEEEWWEWEWEEWWWEEWEWWEEEWWEEEEEEWEWWEEEEWEWEEEWEWWWWWWEEWWEWWWWEEEEEEWWWEWWEWWWWWEEWWEWEWEWWWWWWEEWEWWEEEWWEWWEEEWEEWEEWEEEWWEEEEWWE
WWWWWDWEEEEWEWWWEWEWEWWEWEWEEWEEEEEEEEEWEEEWEWWEEEEWEWEWWWEWEEWEEWWWWEEWEWEEWWEEEEEWWWEEWWEWEEWWEWWEEEWWWEWEEEWWWEEEEEEEWEWEEEEWWEEWEEWWWEEEWEEWWWWEWEEEWWWWWEWEEWEEEWEEEW
EEWEWWWWEWEEWEWWWWEWEEEEEWEWEWWWWEWEWWEEEEWEWWWEWEEEEEWEEWEEWWEWWWWWWWWEEWEEEEEWWEEWWWEWWWEEEEWEEWEWEWWWWWWEWWEWEWWEWEEWEEWEEWWWWEEEWWEEEEEEEEWEEWWEWEEEEWEWEEEEWEEEWWWWWW
EWEWEEWEWWEEEWEWWEEEWWEWWWEEWWWWEEEWWWEEEWWEEWWEEEEEEWEEEWWEWWEWEEWEEEWWWEWWWWEEWEWEEEEWEWWWWWEEEEEWEEWEWEEEWEEEWEEEEWWWEWWEEWEEWEWWWWEEWEWEEEWWWEWEEEWWEWEWEEEEWWWEEEWWWW
EWEEEEWEEWWWWEEWEWEEWWEWWEWEEWWWEEEWEWWWEEEEEEEEWWEWEWEWWWEWWWEWWEWWEEEEEEEWEWEWEEEEWWWEEWEWEWWWWWWEEEEEWEWEEWEWWEWWEWWEEEEWWEWWWEEWWEWEEEWEEWWWEEWWEEWEWEEEEWWWWWWWWWEEEW
WWEEEWWWEEEEWWEEWEEEEWWEEWWWWWEEEEWEEEEWWEWEEEWWWEEWWWWWEEEEEWWEEWWEWWWWWEEWEEEEEEEEWWEEEEWEWEEEWWWEEWEWEWEWWEWWEWEWWWWWEWEEWWEEWEWWWWWWEEWWEEEEEWEEWEEWEEWWEWWEWWEWEWEEEE
