EEWWWWEEWEEEEEWEWEEEEEWWEEEEEEEEWEWEWWEEEEEEWWE
WEEEWEWEEEEEEWEEWWEWEEEEEWEWEWEEEEEEEEWEEWEEWEW
EWWWEEEEEWEEEEEWWWWWDWWEEWWWWWWWWWWWWWEWEEEWEWE
WWEEWEWWWWEWEEWWEEEEWWWWWWEEWWEWEWEEWEWEWEEWEWW
WEWWWEWEWEWWEEEEWWWEEEWWEEWEEWWWWWEEWEWWEEWWWEW
WEEWWWWEEWWEEEWEEWEWWEEEWWEEEEEEEEWEWWWEWWWWEEE
EEEWEWEWWEWEWEWEWEWEEWWEWWWWEEEWEWEWEWWWWEWWEEE
EEEEEWEEEWEWEEEEEEEWWEEWWWEEWEEWWEEEWEEEEWEEEWE
WWWWEEEWEWEEEEEEEWEWWWWEWWEEEWEEEWWEWEEEWEWWEEW
WEAEEWEEWWWEEWEWWEWWWWEWWEEWEWEWEEEWEEWWEEWEWWE
EWEWWEWEEEWWWWEWEEEWEWWWWWEWWWWEEEEEEWWEEEWWEEW
EEEWEWWWEEEWWWEEWEWEEWWEWWEEEEWEEEWEEEEWWWEEWEE
WEEEEEEWWWEEWWWWWEEEWEWWEWWEWWWEEWEEWEWEWEEWEWE
WEEWEEWWWWWWEEWEWWEWWWEEEWWEEWWEWWEEWEWWWEEWWEE
EEWWWEEWWEEEEEEEWEWWWWEWEWEEWWWEEEEEEWWWEEEEEWW
WEWEWWEEEEEWWWWWWWWWEEEWEWWEEEWWWWWEWEEWEWWWWEE
WWWWWWEEEEWWWEEEWEEEEWWWEEWWEWWEWEEEWWEWEEEWEWW
EWWWWWWEWEWWWEEEWEWWEWWEWEEEWEWWEWEWWWEWWWEWEWE
WEWEWWWWWEEEEEWWEWWEWEWEEEEWWEEWWWEEWEEEWWEWWEW
WWWEEEEWWWEEWEWWEEWEWEWEWEEEWWEEWEWEEWWEWEEEEWE
EEEWEEEEEWWEWWWEWEEEEEWEEEWWWWEWEEWEEWWEWWWEEEE
EWWWWWWWWWWWEWWEWEWWEWWWWEWEWWWWEEWEEEEEEEEWWEW
