EEWWWWEWEEEEWEWWEEWEEWEEWWEWWEWEW
EWWWEEWEWEEWEEWEEWEWWEEEEEEEEWEEW
WWEEWEWEWEEEEWEEWEEEEWEWWWWWWEWEW
EEWEEEWEWWWEWWEWWEWEEWEEWWWEWEEWW
EWWEWWEWWEWEWWWEWWWEEWWWEWWEWEEEE
EWWWWEDWWEEWEEWWWWWEWEEEEWWWEEWWE
WEEEEWWWWEWEWEWEEEWEEWWWAWEEWWWWE
EWEEEEEEWEWEEEEEWWWEEWWWWWEWWWEWE
WEEWWWEEWWEEWEEEWEEWEWEEWEWEEWEWE
WWWEEEEWWWEEWEWWWEEEWEEEEEEWEEWWE
EEWEWWWWWEWEEWWWWEEEEWWEEEWWEEWEE
EEEWEWWWWEEEEEWEWWEWEWWEEEWWWEWWE
EWWWWWWWWWEEWWWWWWWEWEWWEWEEWEEEE
EEEEEEEEEEWWWWEWWEWEWEEEWWEWEWWWE
EWWWWWWWEWWEEEWWWEWWEWWEEEEWWEEWW
