WWWEEEWWEEEEEEEWEWEWEWWEWEEEEEWW
EWEEWWEEWEWWWWEEEEEWEEWEEWWWWEEE
EWEWWWWWWEWWEEEWEEWEWEEEEWWWWWEW
EWEEEEWEEWWEEWEWEWEWEEWWEEEWWEWW
WEWEEEEEWEEWWWEWEEEEWEEWWEWEWWEE
WEWEWEEEWWWEWWWEWWEEWEEWWWWWWEWW
WWEEWWWWEEWEEWWEEWEEWEEWEEWEEEEW
EEWEWEWWEEWEEWWWWWWEWEWEEEWEEEWE
EEWWWEWWWEWAEWWEEEEEWEEWWWWWWEWE
EEWWWWEEEWEWWEWWWEWEWEWEEWWEWEDE
EWEWWWEEEEEEWWEWEWWEWWEEEWWEEEEW
EEEWWEEWWEEWEEEWWEWEWEWWEWEWEEWW
WWWEWEEWEWWWWWEWWEWEWWWEEWWWEWEE
WEWEEEWWWWWEWWWWEWWEEEWWEWWEEWWE
WWWWEWEEEEWWEWWWEWEWEWEWEEWWWEWW
EWWWWWWWEEEWWEEWEWEEWEEEEWEEEWEW
